fa-glass : Glass
fa-music : Music
fa-search : Search
fa-envelope-o : Envelope Outlined
fa-heart : Heart
fa-star : Star
fa-star-o : Star Outlined
fa-user : User
fa-film : Film
fa-th-large : Th-large
fa-th : Th
fa-th-list : Th-list
fa-check : Check
fa-times : Times
fa-search-plus : Search Plus
fa-search-minus : Search Minus
fa-power-off : Power Off
fa-signal : Signal
fa-cog : Cog
fa-trash-o : Trash Outlined
fa-home : Home
fa-file-o : File Outlined
fa-clock-o : Clock Outlined
fa-road : Road
fa-download : Download
fa-arrow-circle-o-down : Arrow Circle Outlined Down
fa-arrow-circle-o-up : Arrow Circle Outlined Up
fa-inbox : Inbox
fa-play-circle-o : Play Circle Outlined
fa-repeat : Repeat
fa-refresh : Refresh
fa-list-alt : List-alt
fa-lock : Lock
fa-flag : Flag
fa-headphones : Headphones
fa-volume-off : Volume-off
fa-volume-down : Volume-down
fa-volume-up : Volume-up
fa-qrcode : Qrcode
fa-barcode : Barcode
fa-tag : Tag
fa-tags : Tags
fa-book : Book
fa-bookmark : Bookmark
fa-print : Print
fa-camera : Camera
fa-font : Font
fa-bold : Bold
fa-italic : Italic
fa-text-height : Text-height
fa-text-width : Text-width
fa-align-left : Align-left
fa-align-center : Align-center
fa-align-right : Align-right
fa-align-justify : Align-justify
fa-list : List
fa-outdent : Outdent
fa-indent : Indent
fa-video-camera : Video Camera
fa-picture-o : Picture Outlined
fa-pencil : Pencil
fa-map-marker : Map-marker
fa-adjust : Adjust
fa-tint : Tint
fa-pencil-square-o : Pencil Square Outlined
fa-share-square-o : Share Square Outlined
fa-check-square-o : Check Square Outlined
fa-arrows : Arrows
fa-step-backward : Step-backward
fa-fast-backward : Fast-backward
fa-backward : Backward
fa-play : Play
fa-pause : Pause
fa-stop : Stop
fa-forward : Forward
fa-fast-forward : Fast-forward
fa-step-forward : Step-forward
fa-eject : Eject
fa-chevron-left : Chevron-left
fa-chevron-right : Chevron-right
fa-plus-circle : Plus Circle
fa-minus-circle : Minus Circle
fa-times-circle : Times Circle
fa-check-circle : Check Circle
fa-question-circle : Question Circle
fa-info-circle : Info Circle
fa-crosshairs : Crosshairs
fa-times-circle-o : Times Circle Outlined
fa-check-circle-o : Check Circle Outlined
fa-ban : Ban
fa-arrow-left : Arrow-left
fa-arrow-right : Arrow-right
fa-arrow-up : Arrow-up
fa-arrow-down : Arrow-down
fa-share : Share
fa-expand : Expand
fa-compress : Compress
fa-plus : Plus
fa-minus : Minus
fa-asterisk : Asterisk
fa-exclamation-circle : Exclamation Circle
fa-gift : Gift
fa-leaf : Leaf
fa-fire : Fire
fa-eye : Eye
fa-eye-slash : Eye Slash
fa-exclamation-triangle : Exclamation Triangle
fa-plane : Plane
fa-calendar : Calendar
fa-random : Random
fa-comment : Comment
fa-magnet : Magnet
fa-chevron-up : Chevron-up
fa-chevron-down : Chevron-down
fa-retweet : Retweet
fa-shopping-cart : Shopping-cart
fa-folder : Folder
fa-folder-open : Folder Open
fa-arrows-v : Arrows Vertical
fa-arrows-h : Arrows Horizontal
fa-bar-chart : Bar Chart
fa-twitter-square : Twitter Square
fa-facebook-square : Facebook Square
fa-camera-retro : Camera-retro
fa-key : Key
fa-cogs : Cogs
fa-comments : Comments
fa-thumbs-o-up : Thumbs Up Outlined
fa-thumbs-o-down : Thumbs Down Outlined
fa-star-half : Star-half
fa-heart-o : Heart Outlined
fa-sign-out : Sign Out
fa-linkedin-square : LinkedIn Square
fa-thumb-tack : Thumb Tack
fa-external-link : External Link
fa-sign-in : Sign In
fa-trophy : Trophy
fa-github-square : GitHub Square
fa-upload : Upload
fa-lemon-o : Lemon Outlined
fa-phone : Phone
fa-square-o : Square Outlined
fa-bookmark-o : Bookmark Outlined
fa-phone-square : Phone Square
fa-twitter : Twitter
fa-facebook : Facebook
fa-github : GitHub
fa-unlock : Unlock
fa-credit-card : Credit-card
fa-rss : Rss
fa-hdd-o : HDD
fa-bullhorn : Bullhorn
fa-bell : Bell
fa-certificate : Certificate
fa-hand-o-right : Hand Outlined Right
fa-hand-o-left : Hand Outlined Left
fa-hand-o-up : Hand Outlined Up
fa-hand-o-down : Hand Outlined Down
fa-arrow-circle-left : Arrow Circle Left
fa-arrow-circle-right : Arrow Circle Right
fa-arrow-circle-up : Arrow Circle Up
fa-arrow-circle-down : Arrow Circle Down
fa-globe : Globe
fa-wrench : Wrench
fa-tasks : Tasks
fa-filter : Filter
fa-briefcase : Briefcase
fa-arrows-alt : Arrows Alt
fa-users : Users
fa-link : Link
fa-cloud : Cloud
fa-flask : Flask
fa-scissors : Scissors
fa-files-o : Files Outlined
fa-paperclip : Paperclip
fa-floppy-o : Floppy Outlined
fa-square : Square
fa-bars : Bars
fa-list-ul : List-ul
fa-list-ol : List-ol
fa-strikethrough : Strikethrough
fa-underline : Underline
fa-table : Table
fa-magic : Magic
fa-truck : Truck
fa-pinterest : Pinterest
fa-pinterest-square : Pinterest Square
fa-google-plus-square : Google Plus Square
fa-google-plus : Google Plus
fa-money : Money
fa-caret-down : Caret Down
fa-caret-up : Caret Up
fa-caret-left : Caret Left
fa-caret-right : Caret Right
fa-columns : Columns
fa-sort : Sort
fa-sort-desc : Sort Descending
fa-sort-asc : Sort Ascending
fa-envelope : Envelope
fa-linkedin : LinkedIn
fa-undo : Undo
fa-gavel : Gavel
fa-tachometer : Tachometer
fa-comment-o : Comment-o
fa-comments-o : Comments-o
fa-bolt : Lightning Bolt
fa-sitemap : Sitemap
fa-umbrella : Umbrella
fa-clipboard : Clipboard
fa-lightbulb-o : Lightbulb Outlined
fa-exchange : Exchange
fa-cloud-download : Cloud Download
fa-cloud-upload : Cloud Upload
fa-user-md : User-md
fa-stethoscope : Stethoscope
fa-suitcase : Suitcase
fa-bell-o : Bell Outlined
fa-coffee : Coffee
fa-cutlery : Cutlery
fa-file-text-o : File Text Outlined
fa-building-o : Building Outlined
fa-hospital-o : Hospital Outlined
fa-ambulance : Ambulance
fa-medkit : Medkit
fa-fighter-jet : Fighter-jet
fa-beer : Beer
fa-h-square : H Square
fa-plus-square : Plus Square
fa-angle-double-left : Angle Double Left
fa-angle-double-right : Angle Double Right
fa-angle-double-up : Angle Double Up
fa-angle-double-down : Angle Double Down
fa-angle-left : Angle-left
fa-angle-right : Angle-right
fa-angle-up : Angle-up
fa-angle-down : Angle-down
fa-desktop : Desktop
fa-laptop : Laptop
fa-tablet : Tablet
fa-mobile : Mobile Phone
fa-circle-o : Circle Outlined
fa-quote-left : Quote-left
fa-quote-right : Quote-right
fa-spinner : Spinner
fa-circle : Circle
fa-reply : Reply
fa-github-alt : GitHub Alt
fa-folder-o : Folder Outlined
fa-folder-open-o : Folder Open Outlined
fa-smile-o : Smile Outlined
fa-frown-o : Frown Outlined
fa-meh-o : Meh Outlined
fa-gamepad : Gamepad
fa-keyboard-o : Keyboard Outlined
fa-flag-o : Flag Outlined
fa-flag-checkered : Flag-checkered
fa-terminal : Terminal
fa-code : Code
fa-reply-all : Reply-all
fa-star-half-o : Star Half Outlined
fa-location-arrow : Location-arrow
fa-crop : Crop
fa-code-fork : Code-fork
fa-chain-broken : Chain Broken
fa-question : Question
fa-info : Info
fa-exclamation : Exclamation
fa-superscript : Superscript
fa-subscript : Subscript
fa-eraser : Eraser
fa-puzzle-piece : Puzzle Piece
fa-microphone : Microphone
fa-microphone-slash : Microphone Slash
fa-shield : Shield
fa-calendar-o : Calendar-o
fa-fire-extinguisher : Fire-extinguisher
fa-rocket : Rocket
fa-maxcdn : MaxCDN
fa-chevron-circle-left : Chevron Circle Left
fa-chevron-circle-right : Chevron Circle Right
fa-chevron-circle-up : Chevron Circle Up
fa-chevron-circle-down : Chevron Circle Down
fa-html5 : HTML 5 Logo
fa-css3 : CSS 3 Logo
fa-anchor : Anchor
fa-unlock-alt : Unlock Alt
fa-bullseye : Bullseye
fa-ellipsis-h : Ellipsis Horizontal
fa-ellipsis-v : Ellipsis Vertical
fa-rss-square : RSS Square
fa-play-circle : Play Circle
fa-ticket : Ticket
fa-minus-square : Minus Square
fa-minus-square-o : Minus Square Outlined
fa-level-up : Level Up
fa-level-down : Level Down
fa-check-square : Check Square
fa-pencil-square : Pencil Square
fa-external-link-square : External Link Square
fa-share-square : Share Square
fa-compass : Compass
fa-caret-square-o-down : Caret Square Outlined Down
fa-caret-square-o-up : Caret Square Outlined Up
fa-caret-square-o-right : Caret Square Outlined Right
fa-eur : Euro (EUR)
fa-gbp : GBP
fa-usd : US Dollar
fa-inr : Indian Rupee (INR)
fa-jpy : Japanese Yen (JPY)
fa-rub : Russian Ruble (RUB)
fa-krw : Korean Won (KRW)
fa-btc : Bitcoin (BTC)
fa-file : File
fa-file-text : File Text
fa-sort-alpha-asc : Sort Alpha Ascending
fa-sort-alpha-desc : Sort Alpha Descending
fa-sort-amount-asc : Sort Amount Ascending
fa-sort-amount-desc : Sort Amount Descending
fa-sort-numeric-asc : Sort Numeric Ascending
fa-sort-numeric-desc : Sort Numeric Descending
fa-thumbs-up : Thumbs-up
fa-thumbs-down : Thumbs-down
fa-youtube-square : YouTube Square
fa-youtube : YouTube
fa-xing : Xing
fa-xing-square : Xing Square
fa-youtube-play : YouTube Play
fa-dropbox : Dropbox
fa-stack-overflow : Stack Overflow
fa-instagram : Instagram
fa-flickr : Flickr
fa-adn : App.net
fa-bitbucket : Bitbucket
fa-bitbucket-square : Bitbucket Square
fa-tumblr : Tumblr
fa-tumblr-square : Tumblr Square
fa-long-arrow-down : Long Arrow Down
fa-long-arrow-up : Long Arrow Up
fa-long-arrow-left : Long Arrow Left
fa-long-arrow-right : Long Arrow Right
fa-apple : Apple
fa-windows : Windows
fa-android : Android
fa-linux : Linux
fa-dribbble : Dribbble
fa-skype : Skype
fa-foursquare : Foursquare
fa-trello : Trello
fa-female : Female
fa-male : Male
fa-gratipay : Gratipay (Gittip)
fa-sun-o : Sun Outlined
fa-moon-o : Moon Outlined
fa-archive : Archive
fa-bug : Bug
fa-vk : VK
fa-weibo : Weibo
fa-renren : Renren
fa-pagelines : Pagelines
fa-stack-exchange : Stack Exchange
fa-arrow-circle-o-right : Arrow Circle Outlined Right
fa-arrow-circle-o-left : Arrow Circle Outlined Left
fa-caret-square-o-left : Caret Square Outlined Left
fa-dot-circle-o : Dot Circle Outlined
fa-wheelchair : Wheelchair
fa-vimeo-square : Vimeo Square
fa-try : Turkish Lira (TRY)
fa-plus-square-o : Plus Square Outlined
fa-space-shuttle : Space Shuttle
fa-slack : Slack Logo
fa-envelope-square : Envelope Square
fa-wordpress : WordPress Logo
fa-openid : OpenID
fa-university : University
fa-graduation-cap : Graduation Cap
fa-yahoo : Yahoo Logo
fa-google : Google Logo
fa-reddit : Reddit Logo
fa-reddit-square : Reddit Square
fa-stumbleupon-circle : StumbleUpon Circle
fa-stumbleupon : StumbleUpon Logo
fa-delicious : Delicious Logo
fa-digg : Digg Logo
fa-pied-piper-pp : Pied Piper PP Logo (Old)
fa-pied-piper-alt : Pied Piper Alternate Logo
fa-drupal : Drupal Logo
fa-joomla : Joomla Logo
fa-language : Language
fa-fax : Fax
fa-building : Building
fa-child : Child
fa-paw : Paw
fa-spoon : Spoon
fa-cube : Cube
fa-cubes : Cubes
fa-behance : Behance
fa-behance-square : Behance Square
fa-steam : Steam
fa-steam-square : Steam Square
fa-recycle : Recycle
fa-car : Car
fa-taxi : Taxi
fa-tree : Tree
fa-spotify : Spotify
fa-deviantart : DeviantART
fa-soundcloud : SoundCloud
fa-database : Database
fa-file-pdf-o : PDF File Outlined
fa-file-word-o : Word File Outlined
fa-file-excel-o : Excel File Outlined
fa-file-powerpoint-o : Powerpoint File Outlined
fa-file-image-o : Image File Outlined
fa-file-archive-o : Archive File Outlined
fa-file-audio-o : Audio File Outlined
fa-file-video-o : Video File Outlined
fa-file-code-o : Code File Outlined
fa-vine : Vine
fa-codepen : Codepen
fa-jsfiddle : JsFiddle
fa-life-ring : Life Ring
fa-circle-o-notch : Circle Outlined Notched
fa-rebel : Rebel Alliance
fa-empire : Galactic Empire
fa-git-square : Git Square
fa-git : Git
fa-hacker-news : Hacker News
fa-tencent-weibo : Tencent Weibo
fa-qq : QQ
fa-weixin : Weixin (WeChat)
fa-paper-plane : Paper Plane
fa-paper-plane-o : Paper Plane Outlined
fa-history : History
fa-circle-thin : Circle Outlined Thin
fa-header : Header
fa-paragraph : Paragraph
fa-sliders : Sliders
fa-share-alt : Share Alt
fa-share-alt-square : Share Alt Square
fa-bomb : Bomb
fa-futbol-o : Futbol Outlined
fa-tty : TTY
fa-binoculars : Binoculars
fa-plug : Plug
fa-slideshare : Slideshare
fa-twitch : Twitch
fa-yelp : Yelp
fa-newspaper-o : Newspaper Outlined
fa-wifi : WiFi
fa-calculator : Calculator
fa-paypal : Paypal
fa-google-wallet : Google Wallet
fa-cc-visa : Visa Credit Card
fa-cc-mastercard : MasterCard Credit Card
fa-cc-discover : Discover Credit Card
fa-cc-amex : American Express Credit Card
fa-cc-paypal : Paypal Credit Card
fa-cc-stripe : Stripe Credit Card
fa-bell-slash : Bell Slash
fa-bell-slash-o : Bell Slash Outlined
fa-trash : Trash
fa-copyright : Copyright
fa-at : At
fa-eyedropper : Eyedropper
fa-paint-brush : Paint Brush
fa-birthday-cake : Birthday Cake
fa-area-chart : Area Chart
fa-pie-chart : Pie Chart
fa-line-chart : Line Chart
fa-lastfm : Last.fm
fa-lastfm-square : Last.fm Square
fa-toggle-off : Toggle Off
fa-toggle-on : Toggle On
fa-bicycle : Bicycle
fa-bus : Bus
fa-ioxhost : Ioxhost
fa-angellist : AngelList
fa-cc : Closed Captions
fa-ils : Shekel (ILS)
fa-meanpath : Meanpath
fa-buysellads : BuySellAds
fa-connectdevelop : Connect Develop
fa-dashcube : DashCube
fa-forumbee : Forumbee
fa-leanpub : Leanpub
fa-sellsy : Sellsy
fa-shirtsinbulk : Shirts in Bulk
fa-simplybuilt : SimplyBuilt
fa-skyatlas : Skyatlas
fa-cart-plus : Add to Shopping Cart
fa-cart-arrow-down : Shopping Cart Arrow Down
fa-diamond : Diamond
fa-ship : Ship
fa-user-secret : User Secret
fa-motorcycle : Motorcycle
fa-street-view : Street View
fa-heartbeat : Heartbeat
fa-venus : Venus
fa-mars : Mars
fa-mercury : Mercury
fa-transgender : Transgender
fa-transgender-alt : Transgender Alt
fa-venus-double : Venus Double
fa-mars-double : Mars Double
fa-venus-mars : Venus Mars
fa-mars-stroke : Mars Stroke
fa-mars-stroke-v : Mars Stroke Vertical
fa-mars-stroke-h : Mars Stroke Horizontal
fa-neuter : Neuter
fa-genderless : Genderless
fa-facebook-official : Facebook Official
fa-pinterest-p : Pinterest P
fa-whatsapp : What's App
fa-server : Server
fa-user-plus : Add User
fa-user-times : Remove User
fa-bed : Bed
fa-viacoin : Viacoin
fa-train : Train
fa-subway : Subway
fa-medium : Medium
fa-y-combinator : Y Combinator
fa-optin-monster : Optin Monster
fa-opencart : OpenCart
fa-expeditedssl : ExpeditedSSL
fa-battery-full : Battery Full
fa-battery-three-quarters : Battery 3/4 Full
fa-battery-half : Battery 1/2 Full
fa-battery-quarter : Battery 1/4 Full
fa-battery-empty : Battery Empty
fa-mouse-pointer : Mouse Pointer
fa-i-cursor : I Beam Cursor
fa-object-group : Object Group
fa-object-ungroup : Object Ungroup
fa-sticky-note : Sticky Note
fa-sticky-note-o : Sticky Note Outlined
fa-cc-jcb : JCB Credit Card
fa-cc-diners-club : Diner's Club Credit Card
fa-clone : Clone
fa-balance-scale : Balance Scale
fa-hourglass-o : Hourglass Outlined
fa-hourglass-start : Hourglass Start
fa-hourglass-half : Hourglass Half
fa-hourglass-end : Hourglass End
fa-hourglass : Hourglass
fa-hand-rock-o : Rock (Hand)
fa-hand-paper-o : Paper (Hand)
fa-hand-scissors-o : Scissors (Hand)
fa-hand-lizard-o : Lizard (Hand)
fa-hand-spock-o : Spock (Hand)
fa-hand-pointer-o : Hand Pointer
fa-hand-peace-o : Hand Peace
fa-trademark : Trademark
fa-registered : Registered Trademark
fa-creative-commons : Creative Commons
fa-gg : GG Currency
fa-gg-circle : GG Currency Circle
fa-tripadvisor : TripAdvisor
fa-odnoklassniki : Odnoklassniki
fa-odnoklassniki-square : Odnoklassniki Square
fa-get-pocket : Get Pocket
fa-wikipedia-w : Wikipedia W
fa-safari : Safari
fa-chrome : Chrome
fa-firefox : Firefox
fa-opera : Opera
fa-internet-explorer : Internet-explorer
fa-television : Television
fa-contao : Contao
fa-500px : 500px
fa-amazon : Amazon
fa-calendar-plus-o : Calendar Plus Outlined
fa-calendar-minus-o : Calendar Minus Outlined
fa-calendar-times-o : Calendar Times Outlined
fa-calendar-check-o : Calendar Check Outlined
fa-industry : Industry
fa-map-pin : Map Pin
fa-map-signs : Map Signs
fa-map-o : Map Outlined
fa-map : Map
fa-commenting : Commenting
fa-commenting-o : Commenting Outlined
fa-houzz : Houzz
fa-vimeo : Vimeo
fa-black-tie : Font Awesome Black Tie
fa-fonticons : Fonticons
fa-reddit-alien : Reddit Alien
fa-edge : Edge Browser
fa-credit-card-alt : Credit Card
fa-codiepie : Codie Pie
fa-modx : MODX
fa-fort-awesome : Fort Awesome
fa-usb : USB
fa-product-hunt : Product Hunt
fa-mixcloud : Mixcloud
fa-scribd : Scribd
fa-pause-circle : Pause Circle
fa-pause-circle-o : Pause Circle Outlined
fa-stop-circle : Stop Circle
fa-stop-circle-o : Stop Circle Outlined
fa-shopping-bag : Shopping Bag
fa-shopping-basket : Shopping Basket
fa-hashtag : Hashtag
fa-bluetooth : Bluetooth
fa-bluetooth-b : Bluetooth
fa-percent : Percent
fa-gitlab : GitLab
fa-wpbeginner : WPBeginner
fa-wpforms : WPForms
fa-envira : Envira Gallery
fa-universal-access : Universal Access
fa-wheelchair-alt : Wheelchair Alt
fa-question-circle-o : Question Circle Outlined
fa-blind : Blind
fa-audio-description : Audio Description
fa-volume-control-phone : Volume Control Phone
fa-braille : Braille
fa-assistive-listening-systems : Assistive Listening Systems
fa-american-sign-language-interpreting : American Sign Language Interpreting
fa-deaf : Deaf
fa-glide : Glide
fa-glide-g : Glide G
fa-sign-language : Sign Language
fa-low-vision : Low Vision
fa-viadeo : Viadeo
fa-viadeo-square : Viadeo Square
fa-snapchat : Snapchat
fa-snapchat-ghost : Snapchat Ghost
fa-snapchat-square : Snapchat Square
fa-pied-piper : Pied Piper Logo
fa-first-order : First Order
fa-yoast : Yoast
fa-themeisle : ThemeIsle
fa-google-plus-official : Google Plus Official
fa-font-awesome : Font Awesome
fa-handshake-o : Handshake Outlined
fa-envelope-open : Envelope Open
fa-envelope-open-o : Envelope Open Outlined
fa-linode : Linode
fa-address-book : Address Book
fa-address-book-o : Address Book Outlined
fa-address-card : Address Card
fa-address-card-o : Address Card Outlined
fa-user-circle : User Circle
fa-user-circle-o : User Circle Outlined
fa-user-o : User Outlined
fa-id-badge : Identification Badge
fa-id-card : Identification Card
fa-id-card-o : Identification Card Outlined
fa-quora : Quora
fa-free-code-camp : Free Code Camp
fa-telegram : Telegram
fa-thermometer-full : Thermometer Full
fa-thermometer-three-quarters : Thermometer 3/4 Full
fa-thermometer-half : Thermometer 1/2 Full
fa-thermometer-quarter : Thermometer 1/4 Full
fa-thermometer-empty : Thermometer Empty
fa-shower : Shower
fa-bath : Bath
fa-podcast : Podcast
fa-window-maximize : Window Maximize
fa-window-minimize : Window Minimize
fa-window-restore : Window Restore
fa-window-close : Window Close
fa-window-close-o : Window Close Outline
fa-bandcamp : Bandcamp
fa-grav : Grav
fa-etsy : Etsy
fa-imdb : IMDB
fa-ravelry : Ravelry
fa-eercast : Eercast
fa-microchip : Microchip
fa-snowflake-o : Snowflake Outlined
fa-superpowers : Superpowers
fa-wpexplorer : WPExplorer
fa-meetup : Meetup
